300

Place	Operator	Address	Type

Elite Market	Vegas Enterprises

El Mirador Hotel	L. W. Moore

Elwell Bar	Walter Mills

Elwell Coffee Shop	James J. Adras Et Al

Elwell Hotel	Walter Mills

Esquire Bar	Brandhorst Inc. LR Schway

Ethel's Family Liquor Store Gayer Co. - Lee Hughes

Ethel's Family Liquor Store 1st Nat'l Bank of Nevada

Fifth Street Liquor Store Gordon W. Potter

First Street Grocery	Brant Stewart

Fisher Drug Co.	L. P. Lawrence

Fitch Market	Edward Koch

Food Center Inc	L. R. Schway

Foreign Club	Walter Argyle

Fremont Arcade	Irl N. Stewart

Frontier Club Inc.	A. F. Schellang

Frontier Turf Club	Moe Sedway, Morris Rosen

Wm. I. Alderman

Fry's Liquor Store	Ted Patton Music Co

Gilbert Brothers	Bob Metten

Golden Camel Bar	Mrs. J. H. Morgan

Golden Camel Bar	Kroloff Dist. Co

Golden Nuggett	Norman M. Keller, Guy

McAfee, et al

Hangout Bar & Cafe	Vegas Sweet Shop

Harold & Vaughn's Restaurant Robert Peccole
Harold's Drive In	Reed Whittwer

Harris & Wasden Music Hall Ted Patton Music Co
Hickory Wood Bar—B—Q	Hickory Wood Bar—B-Q, Inc

House of Napels	Patsy Malpede

Howdy Pardner Cafe	Vegas Enterprises	Co

J. D.'s Drive Inn	Gayer Co. - Lee Hughe:

Joes' Lunch	C.	W.	Ansley

Johnson's Chevron Station	C.	W.	Ansley

K & K Store	Win. E. Kost &

Rodger M. Kell

Kelly Shell Service	Gayer Co.-Lee Hughes

La Cosita Cafe	Ted Patton Music Co

Lanrep Bar	John F. Miller

Larnins Drug Store	I.	J.	Lamin

Las Vegas Barbecue	Geo. Tsouras