Motion seconded by Commissioner Peccole and carried by the following vote; Commissioners Bunker,

Peccole, Whipple and His Honor voting aye; noes, none. Absent: Commissioner Jarrett.

At this time the Board considered the following applications for renewal of liquor licenses for

the 1st quarter of 1953.	
ALL NITE MARKET ALPINE VILLAGE ALRAY LIQUOR STORE LEGION CLUBHOUSE ANDYS LIQUOR STORE APACHE BAR	Arthur Nunes Pauline Rennert Aldo Barozzi Chester W. Howard Andrew L. Bruner P.O. Silvagni
B.P.O. ELKS LODGE  bonanza market  BOULDER CLUB BOTTLE HOUSE BRIGHT SPOT DRIVE IN BROWN DERBY BAR	BY: Austin Bowler Vesta Hamby BY: C. Hurley Floyd J. Cope BY: Barnie Sullivent P.L. Jefferson
CAFE CAPRI  THE CALIFORNIA CLUB	Abe Feller  The Fremont Arcade
CHARLESTON INN  CHATTERBOX  CINNABAR  CLIFF'S 5th ST. MARK. CLUB SAVOY  COCA COLA BOTTLING CO. COREY'S FINE FOODS CORK N BOTTLE COTTON CLUB CUT RATE LIQUOR STORE	Ronald E. McGarry BY: L.A. Startroen BY: James Fare G.C. Luzier Emile Easa BY: T.H. UNDERHILL BY: James Corey Frank R. Pimental Uvalde Caperton Hughie Roach
DESERT INN LIQUOR DELUCA IMPORTING CO. DUFFY'S TAVERN	George Pappas BY: R.S. Kayser BY: j. Schramm
EIGHT BALL BAR EL CORTEZ BAR EL BBRROGCO BLUB EL RIO LIQUOR STORE EL sombrero CAFE HOTEL ELWELL BAR ESQUIRE BAR	BY: abe Kroloff BX: W.J. Moore Jr. Oscar L. Corzier Hans H. Eberhardt C.J. Griego BY: Wm. H. Elwell Isadora Bernson
5TH STREET LIQUOR STORE FILIPO'S ITALIAN REST.  fitch's market  FOODDAND FORTUNE BOBS FREMONT DRUG	Gordon W. Potter Harriet Ciochetti R.J. Fitch Vegas Foods Co. BY: Hans Wiener BY: H. Parvin
GOLDEN NUGGETT GOLDEN NUGGETT	BY: C.C. King BY: C.C. King
HOUSE OF STEAKS THE HORSESHOE BAR	Malcolm C. Quelch BY: Benny Binion
JERRY'S SNACK BAR	BY: Jerome J. Glotter
KATY DID BAR KEYHOLE BAR	BY: George S. Norris BY: John A. Harrell
L & W CAFE  LAS VEGAS CLUB LOUNGE LAS VEGAS LIQUOR STORE LIDO BAR LINCOLN MARKET LITTLE KITCHEN	Linn Wilson A.F. Schellang Alfred Luidgren Anna Mae Neller Vaughn K. Leavitt Joan L. Seabee
MAIN LIQUOR STORE MAYFAIR LIQUOR STORE MCKESSON LIQUOR CO. MIKE'S 5th ST. MKT. MIKE'S LIQ. STORE MODERN MARKET MONTE CARLO CLUB	Lilliam Winesky Blaine Beckwith BY: A.E. Anderson BY: F.A. Messina Milton K. Dial BY: J.A. Gordon BY: Fred Soly
NEVADA BAR NEVADA BEVERAGE CO.	Patsy Malpede BY: R.J. mcElhone
PARK MARKET PAY LESS DRUG PAYLESS LIQUOR STORE PIONEER CLUB PLAYLAND BAR	Albert Goot Tom O'Larey Joseph Nosanchuck BY: Chariest Addison George G. Parry
RANDLES CAFE RED & WHITE CAFE	Amy Randle Richard X. Kynett

921 S. Main	Ret. Bev.
903 s. 5th	Rest. Bev.
209 Stewart St.	Ret Liq. Mina.
Highway 91	Club Liq.
1320 D Street	Ret. Liq. Mina.
Apache Hofei Bldg.	Tav. Liq.
128 S. 3rd	Club Liq.
508 W. Bonanza Rd.	Ret. Bev.
118 Fremont	Tav. Liq.
827 S. 5th	Pkg. Liq. Ret. Liq.
300 Stewart	Rest. Bev.
320 Monroe	Tav. Liq.
825 s. 5th St.	Rest. Bev.
101-05 Fremont 111 S. 1st	Tav. Liq.
17 West Charleston	Rest. Bev.
#2 Fremont	Tav. Liq.
122 N. 2nd	Tav. Liq.
129 S. 5th	Ret. Bev.
116 Fremont	Tav. Liq.
424 N. Main	Imp. Bev.
402 Fremont	Rest. Bev.
508 Fremont	Liq. License Bev.
500 Jackson St.	Ret. Liq.
132 S. 5th	Ret. Liq. Mina.
1507 S. 5th	Ret. Liq. Mina.
723 N. Main	Whsle. Liq. & Imp. Bev.
1815 S. 5th	Tav. Liq.
117 N. 1st	Tav. Liq.
612 Fremont	Club Liq.
1332 N. E	Tav. Liq.
1314 N. F	Ret. Liq. Mina.
807 S. Main	Rest. Bev.
202 S. 1st	Tav. Liq
120 S. 2nd	Tav. Liq.
725 S. 5th	Ret. Liq. Mina.
614 S. 5th	Rest. Bev.
107 St. Louis	Ret. Bev.
1500 Fremont	Ret. Liq.
109 Fremont	Tav. Liq.
611 Fremont	Ret. liq.
129 Fremont	Tav. Liq.
129 Fremont	Tav. Liq.
1409 S. 5th	Rest. Bev.
128 Fremont	Tav. Cocktail Lounge Rest. Beer & Wine
407 Fremont	Rest. Bev.
113 N. 1st	Tav. Liq.
13 Fremont St.	Tav. Liq.
18 Garces St.	Rest. Bev.
18 Fremont St.	Tav. Liq.
812 E. Fremont	Ret. Liq. Mina.
107 N. 1st	Tav. Liq.
1502 S. 5th	Ret. Bev.
1608-10 Fremont	Rest. Bev.
416-18 N. 5th	Ret. Liq. Mina.
1418 Fremont	Ret. Liq. Mina.
729 N. main	Whlse Liq.
630 S. 5th	Ret. Bev.
106 Fremont	Ret. Liq. Mina.
121 N. 5th	Ret. Liq.
15 Fremont	Tav. Liq.
115 N. 1st	Rest. Bev.
719 N. Main	Whlse Liq. & Imp. Bev.
424 N. 5th	Ret. Bev.
215 Fremont	Ret. Liq.
1509 Fremont	Ret. Liq. Mina.
25 Fremont	Tav. Liq. (2 Operations)
131 S. 1st	Tav. Liq.
1333 N. E St.	Rest. Bev.
801 S. 1st	Rest. Bev.