360

PRECINCT	NAME

29	Anne C. Bennett	Insp.

Betty Lou Slack	Clerk

Alfreda Parker	Clerk

30	Florence Phillips	Insp.

Olivia Brown	Clerk

Ida Louise Wilkins	Clerk

31	Mary L. Goddard	Insp.

Ethel MacCarthy	Clerk

Emil E. Johnson	Clerk

32	Alma H. Shaw	Insp.

Blanche S. Jones	Clerk

Ida Kellough	Clerk

33	Dorothy H. Kelsey	Insp.

John D. Harrington	Insp.

Virginia S. Carey	Clerk

Hazel E. Basler	Clerk

34	Alberta B. Hanks	Insp.

Irene Peeple	Clerk

Verna Lee Wright	Clerk

35a	Laura M. Hrudicka	Insp.

Juanita R. Murphy	Clerk

Virginia Jean Hand	Clerk

35b	Marjorie F. Long	Insp.

Sylvia B. Averett	Clerk

Ada Goebel	Clerk

36	Leona Orrock	Insp.

Louise Thomas	Clerk

S. Artemissia Brewer	Clerk

37	Helen G. Failing	Insp.

Alma E. Galloway	Clerk

Barbara L. Hall	Clerk

38	Margaret E. Hawley	Insp.

Barbara J. Palipkonich	Insp.

Ella L. Brown	Clerk

Adeline E. Hatch	Clerk

39	Mable Reeves	Insp.

Mary E. Pierson	Clerk

M. Elizabeth Galloway	Clerk

40	Ardy Berkabile	Insp.

Anita E. Kastner	Insp.

Elsie Baltis	Clerk

Mildred F. Newell	Clerk

41	Alice Turner	Insp.

Harriet S. Goldsberry	Clerk

Ann M. Hunt	Clerk-

42	Eloise Oliver	Insp.

Lelia M. Hardy	Clerk

Hazel Lavon Adams	Clerk

43	Marcelle Strubelt	Insp.

Gloria Levine	Clerk

Shanna G. Wadsworth	Clerk

44	Madge Pace	Insp.

Sada M. Hampton	Clerk

Jewel M. Nolen	Clerk

Silver E. Kirch	Insp.

45	L. Floyd Keller	Insp.

Elizabeth Whittlesey	Insp.

Pauline P. Stockton	Clerk

Elaine V. Pribble	Clerk

46	Y. M. Marks	Insp.

Grace I. Clement	Clerk

Alice C. Hamilton	Clerk

47	Wallace W. Kingsley	Insp.

June C. Burgess	Clerk

Patricia Walker	Clerk

48	Olive A. Neutson	Insp.

Bert O'Donnell	Insp.

Erline Y. Smith	Clerk

Irma C. Gray	Clerk

49	Donald H. Brockley	Insp.

Nellie M. Swanson	Clerk

Mary Margaret Brockley	Clerk

50	Erma Sutherland	Insp.

Edith Van Patten	Clerk

Lela E. Neagle	Clerk

4-1-59