96

Golden Camel	Joe Morgan

Silver Club	JOe Morgan

Apache Bar	Michael Silvagni

Apache Bar	Michael Silvagni

Apache Hotel	Lena Coulthard

Fremont Arcade	A. W. Ham

Ace Bar	Robert Kroloff

Barney's Grocery	H. G. Tucker

Sills	5th & Charleston

Wimpy's	Orpha Sill Miller

5th St. Cafe	Carl F. Amante

Cotton Club	Uvalde Caperton

Snappy Snacks Cafe Robert R. Bates
Christies Finer Foods-H. C. Levy
The Market Spot	H. C. Levy

Mike's Liquor Store	Mike Gordon

Mom's Cafe	Joseph Anzalone

Club Savoy	Joseph Alexi

Cliff's 5th St. Mkt.	C. C. Luzier

Lees Lunch	Ted Patton

Las Vegas Tavern	J. Kell Houssels

Las Vegas Club	J. Kell Houssels

Ethel's Liquor Store R. E. Saltzman
Pullum's Playhouse R. E. Saltzman
Texaco Silver Station-R. E. Saltzman
Richfield Ser. Station- R. E. Saltzman
Prime Meat & Provisions- L. P. Lawrence
Cinnabar	L. P. Lawrence

Beacon Shop	L. P. Lawrence

Standard Market	L. P. Lawrence

Borax Variety Store	L. P. Lawrence

Johnson-Eplich Meat Co. - L. P. Lawrence
Quality Low Price Mkt. - L. P. Lawrence
Savoy Grill	L. P. Lawrence

Silver State Newsstand - L. P. Lawrence
Steves Restaurant	Walter Mills

Muirs Drive In	Walter Mills

Joe's Lunch	Walter Mills

Cut Rate Liq. Store	Josie Dondich

Save-rite Drug #2	A. Kroloff

Save-rite Drug #3	A. Kroloff

Modern Market	A. Kroloff

Fremont Sweet Shop	A. Kroloff

Apache Bar	A. Kroloff

Apache Hotel	A. Kroloff

The Round Up Casino	A. Kroloff

Lido Bar	A. Kroloff

Nevada Bar	A. Kroloff

The Sportsman Supply	A. Kroloff

Eight Ball Bar	A. Kroloff

City Drug	A. Kroloff

Sal Sagev Cafe	A. Kroloff

Tivoli Tavern	A. Kroloff

Esquire Lounge	A. Kroloff

Desert Castle	A. Kroloff

Tatum's Barbecue	A. Kroloff

Palace Barbecue	A. Kroloff

Doone's Delicatessen Vegas Sweet Shop
The Hang Out	Vegas Sweet Shop

Hinie's Select Dairy Vegas Sweet Shop
S & S Wilshire Serv. Vegas Sweet Shop
B & C. Station	Vegas Sweet Shop

Earl's Service Corner-Vegas Sweet Shop
The Tavern	V. M. Benson

Thrifty Market	Mrs. M. Klein

Market Spot	Lee Hughes

Harold's Drive Inn	Lee Hughes

Shell Service Station-Lee Hughes
Westside Shopping Center - Lee Hughes
Silver State Texaco Sta. - Lee Hughes
Butler's Service Sta. Lee Hughes
Professional Drug	Lee Hughes

Motor Serv. Station	Lee Hughes

Westside Cafe	Lee Hughes

J. D.'s Drive Inn	Lee Hughes

Belverdere Grocery	Lee Hughes

Westside Tavern	Lee Hughes

Cotton Club	Lee Hughes

Slot Machine	Lee Hughes

White Bunny Ice Cream- R. G. Jolley-