140

Sam Taylor	CHICAGO VILLA

Walter Mills	CHILI KING

A. Kroloff	CITY DRUG

G. A. Luzier	CLIFF'S 5TH ST. MARKET

Joseph W. Alexa	CLUB SAVOY

Vegas Enterprises Co.	CONEY ISLAND

John D. Corey	COREY'S FINE FOODS

C.F. Van Tassel, Jr.	CORK 'N BOTTLE

Gerard J. Archibald	CORNET STORES

Uvalde Caperton	COTTON CLUB

Gayer Co. Lee Hughes	COTTON CLUB

Josie Dondich	CUT RATE LIQUOR STORE

George Pappas	DESERT INN LIQUOR STORE

Boysie Ensley	EBONY CLUB

A. Kroloff	EIGHT BALL BAR

Moe Sedway	ELDORADO CLUB, INC

Frank Wilson	EL MOROCCO CLUB

L. R. Schway

Brandhorst, Inc.	ESQUIRE BAR

R. Saltzman	ETHEL'S LIQUOR STORE #2

Gordon W. Potter	FIFTH ST. LIQUOR STORE

Edward Koch	FITCH'S GROCERY

L.	R. Schway	FOOD CENTER, INC.

Walter Argyle	FOREIGN CLUB

Pat Rozzelle	FOURTH ST. SIGNAL SERVICE

M.	B. Abrams	FREMONT ARCADE

Vegas Enterprises Co. FREMONT SWEET SHOP

L.	P. Lawrence	FREMONT TAVERN, INC

A. F. Schellang	FRONTIER CLUB, INC

Moe Sedway	FRONTIER TURF	CLUB

Bob Metten	GILBERT	BROS.

Joe Morgan	GOLDEN CAMEL BAR

M.	T. Shorie	GOLDEN	NUGGET

M. P. Shorie	GOLDEN	NUGGET

L. P. Lawrence	GREAT WESTERN	FOODS,	INC

Pat Rozzelle	HAMBURGER KING

Vegas Sweet Shop

R. Truesdell-H.Ward	THE HANGOUT

Gayer Co.Lee Hughes	HAROLD'S DRIVE IN

Pat Rozzelle	HILLS SHELL SERVICE

Vegas Sweet Shop

R. Truesdell-H.Ward	HINIE'S SELECT DAIRY

Patsy Malpede	HOUSE OF NAPLES

Gayer Co.Lee Hughes	J. D.'S DRIVE INN

Walter Mills	JOE'S LUNCH

John F. Miller	LANREP BAR

J.	Kell Houssels	LAS VEGAS CLUB