BUSINESS	ADDRESS	GAMING EQUIP.

Orange Julius Co.	40$ Fremont St.	5	slots

Ortons Grill	121 So. 5th	3	slots

Overland Hotel	2 Fremont	2	slots

Overland Bar	2 Fremont	4	slots

Oppedyk Jersy Dairy	1000 Mo. Main St.	1	slot

P and B Cafe	201 No. First St.	1	slot

Pearl’s Cafe	 224 No. First St.	2 slots

Pioneer Cocktail Lounge	25 Fremont St.	7	slots

Playland Arcade	129 So. First St.	46	slots

Pioneer Club	25 Fremont St.	38	slots

2 Pan
6 Poker

1	Race Horse Keno
6 "21" games

2	Roulette
2 Craps

Prescription Pharmacy	814 Fremont St.	1	slot

Rancho Grande Creamery	406 So. Second St.	1	slot

Rex Bar	128 So. First St.	2	slots

Recreation Tavern	123 So. Second St.	4	slots

Saveway Drug	14 Fremont St.	1	slot

Smith’s Drive Inn	313 Stewart	2	slots

Stephen's Market	729 So. Fifth St.	3	slots

Sal Sagev Tavern	1 Fremont	8	slots

S.W. Liquor Store	101 Carson	3	slots

L. L. Snyder’s Grocery	300 Bonanza Rd.	3	slots

Smith’s Root Beer Stand	Third & Stewart	1	slot

Silver State News Stand	110 So. Second St.	3	slots

Sill’s Drive Inn	Fifth & Charleston

Sam’s Cafe	320 Fremont St.	5	slots

Salad Bowl Restaurant	122 So. First St.	4	slots

Shady Rest Cafe	F & Jackson Sts.	2	slots

Silver Club	108 No. First St.	1	Roulette

2 "21" game

	2 Craps

Silver State Texaco Station	Fifth & Fremont	1	slot

Sal Sagev Hotel	Main and Fremont	3	slots

Sal Sagev Cafe	Main & Fremont	2	slots

Silver Cafe	106 No. First St.	4	slots

108 No. First St.	2	slots

Slot Machine	101 Fremont St.	35	slots

Thrifty Market	Charleston & Main	3	slots

120 No. First	1	slot

13 Fremont St.	2	slots

Westside Cafe	D & Madison	2	slots

Westside Tavern	B & Wilson Sts.	3	slots

Wimpy’s Cafe	210 Fremont St.	3	slots

White Cross Drug Co.	201 Fremont St.	2	slots

Motion seconded by Commissioner Bates and carried by the
following vote:	Commissioners Baskin, Bates, Clark,

Corradetti, and His Honor voting aye; noes, none.

LIQUOR APPLICATION	Commissioner Clark moved that the application of W. E.

Gold Nugget	Greene for a retail Tavern Liquor License at the

Gold Nugget, 129 E. Fremont St., be granted.

Motion seconded by the Commissioner Baskin and carried
by the following vote:	Commissioners Baskin, Bates,

Corradetti and His Honor voting aye; noes, none.

HOUSE OF MURPHY	Commissioner Clark moved that the application of Guy

Beverage License	H. Murphy for a retail beverage license at 1407 South

Fifth St., namely The House of Murphy, be granted.

Motion seconded by Commissioner Bates and carried by the
following vote:	Commissioners Baskin, Bates, Clark,

Corradetti and His Honor voting aye; noes, none.

FIFTH STREET LIQUOR	Commissioner Baskin moved that the application of Katie

STORE	Potter for a Retail Liquor License at the Fifth St. Liquor

Application Granted	Store, 727 So. Fifth St., be granted.

Motion seconded by Commissioner Clark and carried by the
following vote:	Commissioners Baskin, Bates, Clark voting

aye; noes, Commissioner Corradetti.

TOM'S LIQUOR STORE	Commissioner Baskin moved that the application of Thomas

Application granted	E. Kirby for a Retail Liquor License at Tom's Liquor Store,

1927 So. Main St., be granted.

Motion seconded by Commissioner Clark and carried by the
following vote:	Commissioners Baskin, Bates, Clark and His

Honor voting aye; noes, Commissioner Corradetti.

JOHNSON & OSTENSON	Commissioner Bates moved that the application of Blaine

APPLICATION	Johnson for a Retail Liquor License at Johnson and Ostenson

Denied	Grocery and Market at 602 So. Fifth St., be denied.