CUT RATE LIQUOR	132 South 5th	Harry	Z. Clarke	Retail	Liquor (Mina.)

DAN DEE BAR	203 North 1st	Molly	W. Fitzpatrick

& Ella Cornish	Tavern

DESERT INN LIQUOR STORE 5107 South 5th	George Pappas	Retail Liquor (Mina.)

DIXIE WAFFLE SHOP            24 Fremont	Nathan Young	Restaurant Beverage

EIGHT BALL BAR	117 North 1st	Robert Kroloff &

Abe Kroloff	Tavern

EL CORTEZ BAR	512 Fremont	Hotel Cortez Co.	Tavern

EL SOMBRERO CAFE	807 South Main	C. J. Griego	Restaurant Beverage

ELWELL HOTEL BAR	202 South 1st	Hotel Elwell, Inc.	Tavern

ESQUIRE BAR	120 South 2nd	Thomas J. Tobin	Tavern

FIFTH STREET LIQUOR	725 South 5th	Gordon & Katie Potter 	Retail Liquor (Mina.)

FILIPO'S	614 South 5th	Harriet Cicchetti	Restaurant Beverage

FITCH'S MARKET	107 St Louis	R. J.	Fitch	Retail	Beverage

FOODLAND	1500 Fremont	Vegas	Foods Corp.	Retail	Liquor

49ER CLUB	109 Fremont	J. S.	Pappas &

George Zouganlis	Tavern

FREMONT DRUG	611 Fremont	A. T. Sharp &

Harvey G. Parvin	Retail	Liquor

FRONTIER DELICATESSEN	117 Fremont	Lester Goldring	Restaurant Beverage

GILBERT BROTHERS	314 W. Bonanza	Harry V.T. Gilbert	Retail Liquor (Mina.)

GOLDEN NUGGET	129 Fremont	Golden Nugget, Inc.	Tavern

GOLDFIELD CLUB	116 Fremont	Edward R. Moss	Tavern

HORSESHOE BAR	128 Fremont	Benny Binion	 Tavern-Cocktail Lounge &

Restaurant Beverage

HOUSE OF STEAKS	1409 South 5th	Malcolm C. Quelch	Restaurant Beverage

INTERNAT'L FOOTPRINTERS 5th & Bonanza	John Lytle, Hiran Powell

and Harold Johns	Club Liquor

JERRY'S SNACK BAR	407 Fremont	Jerome J. Glatter	Restaurant Beverage

KATYDID BAR	113 North 1st	Sam. Stearns & George

S. Norris	Tavern

KEYHOLE BAR	13 Fremont	John A. Harrell	Tavern

L & W CAFE	18 Garces	Robert T. & Linn Wilson 	Restaurant Beverage

LAS VEGAS CLUB	18 Fremont	Las Vegas Club

Partnership	Tavern

LAS VEGAS DISTRIBUTING 230 W. Colorado	Jerry E. Masek	Wholesale Liquor &

Importer's Beverage

LAS VEGAS LIQUOR STORE 812 Fremont	 Alfred Lindgren	Retail	Liquor (Mina.)

LIDO BAR	107 North 1st	Anna Mae Weller	Tavern

LOG CABIN BAR	122 North 1st	Albert Mengarelli	Tavern

MAIN LIQUOR STORE	416-418 North 5th	Lillian Winesky	Retail Liquor	(Mina.)

MAYFAIR LIQUOR	1418 Fremont	Blaine Beckwith	Retail Liquor	(Mina.)

MC KESSON LIQUOR	729	North Main	A.	E.	Anderson	Whse Liquor &	Importert's Bev.

MIKE'S LIQUOR STORE	106	Fremont	M.	H.	Gordon	Retail Liquor	(Mina.)

MODERN MARKET	121	North 5th	R.	D.	Bingham	Retail Liquor

MONTE CARLO, INC.	By:	Fred Soly	15	Fremont	Tavern

MONTE CARLO MOTEL

COFFEE SHOP	Marino Brandolini	1600 South Main	Restaurant Beverage

PARK MARKET	Albert Goot	424 North 5th	Retail Beverage

PAYLESS LIQUOR STORE Joseph Nosanchuck	1509 Fremont	Retail Liquor	(Mina.)

PIONEER COCKTAIL LOUNGE	Tavern

PIONEER BEVERAGE BAR  By: Milton B. Page	25 Fremont	Restaurant Beverage